10 429                                                
0 0 0 0 0 0 0 0 0 0 0 0 0 0 0 0 0 0 0 0 0 0 0 0 0 0 0 1 1 1 1 1 1 1 1 1 1 1 1 1 1 1 1 1 1 1 1 1 1 1
0 0 0 0 0 0 0 0 0 0 0 0 0 0 1 0 0 0 0 0 0 0 0 0 0 0 0 1 1 1 1 1 1 1 1 1 1 1 1 1 1 1 1 1 1 1 1 1 1 1
0 0 0 0 0 0 0 0 0 0 0 0 0 0 1 0 0 0 0 0 0 0 0 0 0 0 1 1 1 1 1 1 1 1 1 1 1 1 1 1 1 1 1 1 1 1 1 1 1 1
0 0 0 0 0 0 0 0 0 0 0 0 0 0 1 1 0 0 0 0 0 0 0 0 1 1 1 1 1 1 1 1 1 1 1 1 1 1 1 1 1 1 1 1 1 1 1 1 1 1
0 0 0 0 0 1 1 1 1 0 0 0 0 1 1 1 0 0 0 0 0 0 1 1 1 1 1 1 1 1 1 1 1 1 1 1 1 1 1 1 1 1 1 1 1 1 1 1 1 1
0 0 0 0 0 0 1 1 1 1 1 1 1 1 1 1 1 0 0 1 1 1 1 1 1 1 1 1 1 1 1 1 1 1 1 1 1 1 1 1 1 1 1 1 1 1 1 1 1 1
0 0 0 0 0 1 1 1 1 1 1 1 1 1 1 1 1 1 1 1 1 1 1 1 1 1 1 1 1 1 1 1 1 1 1 1 1 1 1 1 1 1 1 1 1 1 1 1 1 1
0 0 0 0 0 0 0 1 1 1 1 1 1 1 1 1 1 1 1 1 1 1 1 1 1 1 1 1 1 1 1 1 1 1 1 1 1 1 1 1 1 1 1 1 1 1 1 1 1 1
0 0 0 0 0 0 0 0 0 1 1 1 1 1 1 1 1 1 1 1 1 1 1 1 1 1 1 1 1 1 1 1 1 1 1 1 1 1 1 1 1 1 1 1 1 1 1 1 1 1
0 0 0 0 0 0 0 0 0 0 1 1 1 1 1 1 1 1 1 1 1 1 1 1 1 1 1 1 1 1 1 1 1 1 1 1 1 1 1 1 1 1 1 1 1 1 1 1 1 1
0 0 0 0 0 0 0 0 0 0 1 1 1 1 1 1 1 1 1 1 1 1 1 1 1 1 1 1 1 1 1 1 1 1 1 1 1 1 1 1 1 1 1 1 1 1 1 1 1 1
0 0 0 0 0 0 0 0 0 0 0 1 1 1 1 1 1 1 1 1 1 1 1 1 1 1 1 1 1 1 1 1 1 1 1 1 1 1 1 1 1 1 1 1 1 1 1 1 1 1
0 0 0 0 0 0 0 0 0 0 0 1 1 1 1 1 1 1 1 1 1 1 1 1 1 1 1 1 1 1 1 1 1 1 1 1 1 1 1 1 1 1 1 1 1 1 1 1 1 1
0 0 0 0 0 0 0 0 0 0 0 0 1 1 1 1 1 1 1 1 1 1 1 1 1 1 1 1 1 1 1 1 1 1 1 1 1 1 1 1 1 1 1 1 1 1 1 1 1 1
0 0 0 0 0 0 0 0 0 0 0 0 0 1 1 1 1 1 1 1 1 1 1 1 1 1 1 1 1 1 1 1 1 1 1 1 1 1 1 1 1 1 1 1 1 1 1 1 1 1
0 0 0 0 0 0 0 0 0 0 0 0 0 0 1 1 1 1 1 1 1 1 1 1 1 1 1 1 1 1 1 1 1 1 1 1 1 1 1 1 1 1 1 1 1 1 1 1 1 1
0 0 0 0 0 0 0 0 0 0 0 0 0 0 1 1 1 1 1 1 1 1 1 1 1 1 1 1 1 1 1 1 1 1 1 1 1 1 1 1 1 1 1 1 1 1 1 1 1 1
0 0 0 0 0 0 0 0 0 0 0 0 0 1 1 1 1 1 1 1 1 1 1 1 1 1 1 1 1 1 1 1 1 1 1 1 1 1 1 1 1 1 1 1 1 1 1 1 1 1
0 0 0 0 0 0 0 0 0 0 0 0 0 1 1 1 1 1 1 1 1 1 1 1 1 1 1 1 1 1 1 1 1 1 1 1 1 1 1 1 1 1 1 1 1 1 1 1 1 1
0 0 0 0 0 0 0 0 0 0 0 0 0 1 1 1 1 1 1 1 1 1 1 1 1 1 1 1 1 1 1 1 1 1 1 1 1 1 1 1 1 1 1 1 1 1 1 1 1 1
0 0 0 0 0 0 0 0 0 0 0 0 1 0 1 1 1 1 1 1 1 1 1 1 1 1 1 1 1 1 1 1 1 1 1 1 1 1 1 1 1 1 1 1 1 1 1 1 1 1
0 0 0 0 0 0 0 0 0 0 0 0 1 1 1 1 1 1 1 1 1 1 1 1 1 1 1 1 1 1 1 1 1 1 1 1 1 1 1 1 1 1 1 1 1 1 1 1 1 1
0 0 0 0 0 0 0 0 0 0 0 1 1 1 1 1 1 1 1 1 1 1 1 1 1 1 1 1 1 1 1 1 1 1 1 1 1 1 1 1 1 1 1 1 1 1 1 1 1 1
0 0 0 0 0 0 0 0 0 0 0 1 1 1 1 1 1 1 1 1 1 1 1 1 1 1 1 1 1 1 1 1 1 1 1 1 1 1 1 1 1 1 1 1 1 1 0 0 0 0
0 0 0 0 0 0 0 0 0 0 0 1 1 1 1 1 1 1 1 1 1 1 1 1 1 1 1 1 1 1 1 1 1 1 1 1 1 1 1 1 1 1 1 1 1 1 0 0 0 0
0 0 0 0 0 0 0 0 0 0 1 1 1 1 1 1 1 1 1 1 1 1 1 1 1 1 1 1 1 1 1 1 1 1 1 1 1 1 1 1 1 1 1 1 1 1 1 0 0 0
0 0 0 0 0 0 0 0 0 0 1 1 1 1 1 1 1 1 1 1 1 1 1 1 1 1 1 1 1 1 1 1 1 1 1 1 1 1 0 0 0 0 1 1 1 1 1 1 0 0
1 1 1 1 0 0 0 0 0 0 1 1 1 1 1 1 1 1 1 1 1 1 0 0 0 0 0 1 1 1 1 1 1 1 0 0 0 0 0 0 0 0 0 1 1 1 1 1 0 0
1 1 1 1 1 1 1 1 1 1 1 1 1 1 1 1 1 1 1 0 0 0 0 0 0 0 0 0 0 0 1 1 1 0 0 0 0 0 0 0 0 0 0 0 1 1 1 1 0 0
1 1 1 1 1 1 1 1 1 1 1 1 1 1 1 1 1 1 1 0 0 0 0 0 0 0 0 0 0 0 0 0 0 0 0 0 0 0 0 0 0 0 0 0 1 1 1 1 1 0
                                                 
                                                 
0 0 0 0 0 0 0 0 0 0 0 0 0 0 0 0 0 0 0 0 0 0 0 0 0 0 0 3 3 3 8 5 6 4 8 3 6 4 4 6 5 5 3 9 3 7 5 9 8 9
0 0 0 0 0 0 0 0 0 0 0 0 0 0 3 0 0 0 0 0 0 0 0 0 0 0 0 3 3 3 7 6 4 3 9 7 4 4 8 9 9 3 9 3 9 4 7 8 6 9
0 0 0 0 0 0 0 0 0 0 0 0 0 0 3 0 0 0 0 0 0 0 0 0 0 0 3 3 3 3 7 6 3 3 5 6 3 5 5 7 8 3 4 8 3 8 7 5 6 6
0 0 0 0 0 0 0 0 0 0 0 0 0 0 3 3 0 0 0 0 0 0 0 0 3 3 3 3 3 3 4 6 6 9 8 8 7 8 5 3 8 9 6 7 5 5 4 9 3 5
0 0 0 0 0 3 3 3 3 0 0 0 0 3 3 3 0 0 0 0 0 0 3 3 3 3 3 3 3 3 9 7 3 5 4 6 7 5 3 9 8 9 8 7 9 4 4 6 9 3
0 0 0 0 0 0 3 3 3 3 3 3 3 3 3 3 3 0 0 3 3 3 3 3 3 3 3 3 3 3 3 3 7 6 4 4 9 6 7 6 7 7 3 8 7 8 5 7 5 5
0 0 0 0 0 3 3 3 3 3 3 3 3 3 3 3 3 3 3 3 3 3 3 3 3 3 3 3 3 3 3 3 9 9 4 7 5 4 5 6 7 4 5 8 8 9 5 7 8 3
0 0 0 0 0 0 0 3 3 3 3 3 3 3 3 3 3 3 3 3 3 3 3 3 3 3 3 3 3 3 3 3 9 7 8 3 5 5 9 5 4 8 9 3 6 9 5 3 8 7
0 0 0 0 0 0 0 0 0 3 3 3 3 3 3 3 3 3 3 3 3 3 3 3 3 3 3 3 3 3 3 3 6 9 9 3 9 9 3 7 9 8 3 7 3 6 9 3 5 5
0 0 0 0 0 0 0 0 0 0 3 3 3 3 3 3 3 3 3 3 5 5 5 3 3 3 3 3 3 3 3 3 9 7 6 8 5 9 5 4 6 3 3 4 6 4 5 4 9 5
0 0 0 0 0 0 0 0 0 0 3 3 3 3 3 3 3 3 3 3 5 5 5 3 3 3 3 3 3 3 3 3 4 6 6 7 9 9 3 8 4 7 7 3 5 4 4 4 6 3
0 0 0 0 0 0 0 0 0 0 0 3 3 3 3 3 3 3 3 3 5 5 5 3 3 3 3 3 3 3 3 3 3 9 5 3 9 5 4 7 7 3 7 9 9 3 7 7 8 5
0 0 0 0 0 0 0 0 0 0 0 3 3 3 3 3 3 3 3 3 3 3 3 3 3 3 3 3 3 3 3 3 3 3 7 7 9 6 3 4 6 4 9 4 8 3 4 3 9 6
0 0 0 0 0 0 0 0 0 0 0 0 3 3 3 3 3 3 3 3 5 5 5 3 3 3 3 3 3 3 3 3 3 6 9 4 9 4 9 3 5 4 4 7 6 4 9 8 7 4
0 0 0 0 0 0 0 0 0 0 0 0 0 3 3 3 3 3 3 5 5 5 5 5 3 3 3 3 3 3 3 3 3 7 9 5 4 4 7 8 4 4 7 6 3 4 7 3 6 3
0 0 0 0 0 0 0 0 0 0 0 0 0 0 3 3 3 3 3 5 5 5 5 5 3 3 3 3 3 3 3 3 3 5 7 9 5 7 7 9 6 6 4 7 4 9 3 6 3 7
0 0 0 0 0 0 0 0 0 0 0 0 0 0 3 3 3 3 5 5 5 5 5 5 5 3 3 3 3 3 3 3 3 3 9 7 6 3 7 7 9 4 7 6 9 8 5 5 8 4
0 0 0 0 0 0 0 0 0 0 0 0 0 3 3 3 3 5 5 5 5 5 5 5 5 3 3 3 3 3 3 3 3 3 9 8 9 7 8 5 3 7 9 6 4 4 9 7 6 7
0 0 0 0 0 0 0 0 0 0 0 0 0 7 3 3 5 5 5 5 5 5 5 5 5 5 5 3 3 3 3 3 3 3 3 3 3 3 9 9 5 8 4 7 4 5 8 9 6 6
0 0 0 0 0 0 0 0 0 0 0 0 0 8 6 3 5 5 5 5 5 5 5 5 5 5 5 5 5 5 3 3 3 3 3 3 3 3 4 4 5 9 4 7 9 3 4 5 9 5
0 0 0 0 0 0 0 0 0 0 0 0 7 0 6 5 3 5 5 5 5 5 5 5 5 5 5 5 5 5 3 3 3 3 3 3 3 3 8 8 5 4 5 3 4 8 6 4 6 5
0 0 0 0 0 0 0 0 0 0 0 0 6 5 5 5 3 3 3 3 3 3 5 5 5 5 5 5 5 5 5 5 5 3 3 3 3 3 3 7 9 8 4 6 5 6 7 7 4 9
0 0 0 0 0 0 0 0 0 0 0 6 5 5 5 5 5 3 3 3 3 3 3 3 5 5 5 5 5 5 5 5 5 3 3 3 3 3 3 3 6 3 4 3 6 6 3 7 3 4
0 0 0 0 0 0 0 0 0 0 0 6 5 5 5 5 5 3 3 3 3 3 3 3 3 3 3 3 3 3 5 5 5 3 3 3 3 3 3 3 9 7 3 3 5 5 0 0 0 0
0 0 0 0 0 0 0 0 0 0 0 6 5 5 5 5 3 3 3 3 3 3 3 3 3 3 3 3 3 3 5 5 5 3 3 3 3 3 3 3 7 8 3 3 5 6 0 0 0 0
0 0 0 0 0 0 0 0 0 0 7 5 5 5 5 3 3 3 3 3 3 3 3 3 3 3 3 3 3 3 5 5 5 3 3 3 3 3 3 3 0 0 8 4 7 5 8 0 0 0
0 0 0 0 0 0 0 0 0 0 3 3 3 3 3 3 3 3 3 3 3 3 3 3 3 3 3 3 3 3 5 5 5 3 3 3 3 3 0 0 0 0 3 3 7 9 4 4 0 0
3 3 3 3 0 0 0 0 0 0 3 3 3 3 3 3 3 3 3 3 3 3 0 0 0 0 0 3 3 3 5 5 5 3 0 0 0 0 0 0 0 0 0 9 4 6 5 5 0 0
5 5 5 5 7 6 6 6 6 6 5 5 5 5 5 5 5 5 6 0 0 0 0 0 0 0 0 0 0 0 5 5 5 0 0 0 0 0 0 0 0 0 0 0 9 7 6 8 0 0
5 5 5 5 5 5 5 5 5 5 5 5 5 5 5 5 5 5 5 0 0 0 0 0 0 0 0 0 0 0 0 0 0 0 0 0 0 0 0 0 0 0 0 0 3 3 6 6 4 0
                                                 
0 0 0 0 0 0 0 0 0 0 0 0 0 0 0 0 0 0 0 0 0 0 0 0 0 0 0 5 3 5 6 7 6 3 5 6 5 6 7 6 4 7 5 4 4 6 6 6 7 5
0 0 0 0 0 0 0 0 0 0 0 0 0 0 4 0 0 0 0 0 0 0 0 0 0 0 0 5 6 5 6 7 3 4 6 6 7 7 7 4 6 5 3 7 4 6 7 5 4 7
0 0 0 0 0 0 0 0 0 0 0 0 0 0 3 0 0 0 0 0 0 0 0 0 0 0 5 5 5 3 7 7 3 7 5 6 5 6 6 7 5 6 7 6 7 7 6 7 7 5
0 0 0 0 0 0 0 0 0 0 0 0 0 0 2 4 0 0 0 0 0 0 0 0 5 5 5 5 7 3 5 7 5 7 6 6 6 3 7 5 4 7 6 7 6 7 4 5 7 6
0 0 0 0 0 2 7 2 6 0 0 0 0 6 6 6 0 0 0 0 0 0 1 1 5 5 5 5 5 6 6 5 3 4 3 6 6 4 7 5 6 7 6 3 6 7 7 3 7 7
0 0 0 0 0 0 2 5 4 3 5 6 5 4 4 4 2 0 0 2 6 5 4 6 5 4 5 5 5 4 7 7 5 5 5 4 6 6 7 7 7 6 7 6 4 6 6 3 7 6
0 0 0 0 0 5 6 4 2 3 5 3 4 3 4 3 4 6 6 2 2 5 3 2 2 6 5 1 1 1 5 3 5 3 6 3 4 6 6 3 6 4 6 4 7 7 6 6 6 6
0 0 0 0 0 0 0 6 2 5 3 4 5 5 3 3 5 2 5 5 2 5 5 4 2 6 1 1 1 1 7 7 6 6 6 3 7 4 5 7 3 4 7 6 5 3 7 7 6 5
0 0 0 0 0 0 0 0 0 1 2 6 2 3 6 5 2 2 3 5 3 2 6 5 4 2 1 1 1 1 6 4 3 7 6 5 6 3 6 7 7 4 4 7 6 3 4 6 3 6
0 0 0 0 0 0 0 0 0 0 6 2 6 6 6 3 2 5 4 3 6 3 5 4 6 4 1 1 1 1 7 6 7 7 6 5 4 4 7 7 6 6 6 7 7 7 6 7 7 3
0 0 0 0 0 0 0 0 0 0 2 6 4 5 4 5 4 5 5 3 5 2 5 4 2 6 1 1 1 1 7 7 5 7 6 4 3 6 5 5 3 7 6 6 6 5 4 6 5 3
0 0 0 0 0 0 0 0 0 0 0 5 2 6 4 6 6 3 6 2 5 3 6 5 6 6 1 1 6 1 6 4 5 5 6 7 3 6 6 3 6 3 6 6 7 6 7 6 4 3
0 0 0 0 0 0 0 0 0 0 0 3 4 3 6 6 2 2 5 3 6 5 6 4 5 4 1 6 7 7 3 7 4 7 7 7 4 7 4 4 7 4 4 6 6 3 5 5 7 5
0 0 0 0 0 0 0 0 0 0 0 0 6 2 5 6 2 3 3 5 3 2 4 2 4 3 6 4 5 6 6 7 7 5 6 7 3 6 7 7 5 5 3 3 6 6 3 7 3 3
0 0 0 0 0 0 0 0 0 0 0 0 0 6 3 5 3 5 4 6 5 4 3 4 2 3 5 4 4 2 1 7 5 3 4 4 7 6 4 4 7 6 6 5 7 6 7 7 6 7
0 0 0 0 0 0 0 0 0 0 0 0 0 0 2 2 5 4 6 4 5 5 2 2 6 6 2 6 2 3 1 5 7 7 5 5 6 7 7 7 6 3 5 4 3 7 3 5 6 7
0 0 0 0 0 0 0 0 0 0 0 0 0 0 5 4 3 5 3 5 4 5 5 4 2 6 7 6 7 2 1 6 3 6 5 3 5 6 3 7 6 7 7 6 5 7 6 6 7 3
0 0 0 0 0 0 0 0 0 0 0 0 0 2 4 5 3 6 4 2 4 2 4 5 3 2 1 7 5 7 1 1 3 5 6 6 5 4 6 6 7 7 7 3 7 4 6 3 4 4
0 0 0 0 0 0 0 0 0 0 0 0 0 6 5 6 6 6 4 3 3 5 2 5 6 2 1 1 1 1 1 1 3 3 3 4 5 4 6 7 5 7 6 5 4 3 6 5 3 5
0 0 0 0 0 0 0 0 0 0 0 0 0 3 2 6 4 3 2 5 5 5 5 3 2 4 1 1 1 1 1 1 3 6 7 7 5 3 3 6 6 7 6 7 6 6 7 6 5 7
0 0 0 0 0 0 0 0 0 0 0 0 6 0 3 5 5 3 5 2 5 5 4 2 5 3 1 1 1 1 1 1 7 7 6 3 6 6 4 6 7 4 6 3 4 5 3 7 7 5
0 0 0 0 0 0 0 0 0 0 0 0 5 4 2 5 5 6 6 4 3 6 5 3 6 3 1 1 1 1 1 1 3 4 7 6 3 3 5 6 6 3 6 6 6 7 4 6 7 3
0 0 0 0 0 0 0 0 0 0 0 2 4 4 4 6 3 2 4 3 3 6 6 5 4 5 1 1 1 1 1 1 6 7 7 5 6 5 3 7 4 4 7 5 6 6 4 4 6 7
0 0 0 0 0 0 0 0 0 0 0 4 6 3 4 3 2 5 3 3 6 2 3 3 4 3 1 1 1 1 1 1 1 6 7 6 6 7 4 4 4 3 7 5 5 4 0 0 0 0
0 0 0 0 0 0 0 0 0 0 0 5 3 4 4 6 5 4 5 6 3 4 6 4 3 3 1 1 1 1 1 1 1 1 7 7 4 6 4 7 4 4 5 6 6 5 0 0 0 0
0 0 0 0 0 0 0 0 0 0 2 6 3 5 5 5 4 5 2 5 5 2 6 4 2 4 1 1 1 1 1 1 1 1 1 1 1 1 1 1 0 0 5 7 5 5 7 0 0 0
0 0 0 0 0 0 0 0 0 0 5 2 2 4 6 2 3 4 2 4 6 6 2 6 5 6 1 1 1 1 1 1 1 1 1 1 1 1 0 0 0 0 6 6 3 5 7 7 0 0
3 3 3 3 0 0 0 0 0 0 3 3 3 3 3 3 3 3 3 3 3 3 0 0 0 0 0 1 1 1 1 1 1 1 0 0 0 0 0 0 0 0 0 5 4 6 4 7 0 0
3 3 3 3 3 3 3 3 3 3 3 3 3 3 3 3 3 3 3 0 0 0 0 0 0 0 0 0 0 0 1 1 1 0 0 0 0 0 0 0 0 0 0 0 7 7 3 6 0 0
3 3 3 3 3 3 3 3 3 3 3 3 3 3 3 3 3 3 3 0 0 0 0 0 0 0 0 0 0 0 0 0 0 0 0 0 0 0 0 0 0 0 0 0 6 3 7 6 7 0
                                                 
0 0 0 0 0 0 0 0 0 0 0 0 0 0 0 0 0 0 0 0 0 0 0 0 0 0 0 6 6 10 10 10 10 10 10 10 10 10 10 10 10 10 10 10 10 10 10 10 10 10
0 0 0 0 0 0 0 0 0 0 0 0 0 0 3 0 0 0 0 0 0 0 0 0 0 0 0 6 6 10 10 10 10 10 10 10 10 10 10 10 10 10 10 10 10 10 10 10 10 10
0 0 0 0 0 0 0 0 0 0 0 0 0 0 3 0 0 0 0 0 0 0 0 0 0 0 3 6 6 6 6 6 10 10 10 10 10 10 10 10 10 10 10 10 10 10 10 10 10 10
0 0 0 0 0 0 0 0 0 0 0 0 0 0 3 3 0 0 0 0 0 0 0 0 6 6 6 6 1 6 6 10 10 10 10 10 10 10 10 10 10 10 10 10 10 10 10 10 10 10
0 0 0 0 0 7 7 7 7 0 0 0 0 3 3 3 0 0 0 0 0 0 3 3 4 6 6 6 6 6 10 10 10 10 10 10 10 10 10 10 10 10 10 10 10 10 10 10 10 10
0 0 0 0 0 0 7 7 7 7 7 7 7 3 3 3 3 0 0 3 3 3 3 3 4 4 4 4 4 10 10 10 10 10 10 10 10 10 10 10 10 10 10 10 10 10 10 10 10 10
0 0 0 0 0 7 7 7 7 7 7 7 7 7 3 3 3 3 3 3 3 3 3 4 4 4 4 4 4 10 10 10 10 10 10 10 10 10 10 10 10 10 10 10 10 10 10 10 10 10
0 0 0 0 0 0 0 7 7 7 7 7 7 7 3 3 3 3 3 3 3 3 3 4 4 4 4 1 4 4 10 10 10 10 10 10 10 10 10 10 10 10 10 10 10 10 10 10 10 10
0 0 0 0 0 0 0 0 0 7 7 7 7 7 3 3 3 3 3 3 3 3 3 3 4 4 4 4 4 4 10 10 10 10 10 10 10 10 10 10 10 10 10 10 10 10 10 10 10 10
0 0 0 0 0 0 0 0 0 0 7 7 7 7 3 3 3 3 3 3 3 3 4 4 4 4 4 4 4 4 4 10 10 10 10 10 10 10 10 10 10 10 10 10 10 10 10 10 10 10
0 0 0 0 0 0 0 0 0 0 7 7 7 7 1 1 1 1 1 1 4 4 4 4 4 4 4 4 4 4 4 10 10 10 10 10 10 10 10 10 10 10 10 10 10 10 10 10 10 10
0 0 0 0 0 0 0 0 0 0 0 7 1 1 1 1 1 1 1 1 1 1 1 1 4 4 4 4 4 4 4 4 4 10 10 10 10 10 10 10 10 10 10 10 10 10 10 10 10 10
0 0 0 0 0 0 0 0 0 0 0 1 1 1 1 1 1 1 1 1 1 1 1 1 1 1 1 5 4 4 4 4 4 4 10 10 10 10 10 10 10 10 10 10 10 10 10 10 10 10
0 0 0 0 0 0 0 0 0 0 0 0 1 1 1 1 1 1 1 1 1 1 1 1 1 1 5 5 5 5 5 4 4 4 10 10 10 10 10 10 10 10 10 10 10 10 10 10 10 10
0 0 0 0 0 0 0 0 0 0 0 0 0 1 1 1 1 1 1 1 1 1 1 1 1 5 5 5 5 5 5 5 4 5 5 10 10 10 10 10 10 10 10 10 10 10 10 10 10 10
0 0 0 0 0 0 0 0 0 0 0 0 0 0 1 1 1 1 1 2 1 1 1 1 1 1 5 5 5 5 5 5 5 5 10 10 10 10 10 10 10 10 10 10 10 10 10 10 10 10
0 0 0 0 0 0 0 0 0 0 0 0 0 0 1 1 1 2 2 2 2 1 1 1 1 1 1 5 5 5 5 5 5 10 10 10 10 10 10 10 10 10 10 10 10 10 10 10 10 10
0 0 0 0 0 0 0 0 0 0 0 0 0 1 1 1 2 2 2 2 2 1 1 1 1 1 1 1 5 5 5 10 10 10 10 10 10 10 10 10 10 10 10 10 10 10 10 10 10 10
0 0 0 0 0 0 0 0 0 0 0 0 0 1 1 2 2 2 2 1 1 1 1 1 1 1 1 1 1 1 1 10 10 10 10 10 10 10 10 10 10 10 10 10 10 10 10 10 10 10
0 0 0 0 0 0 0 0 0 0 0 0 0 1 2 2 2 2 1 1 1 1 1 1 1 1 1 1 1 1 1 10 10 10 10 10 10 10 10 10 10 10 10 10 10 10 10 10 10 10
0 0 0 0 0 0 0 0 0 0 0 0 2 0 2 2 2 1 1 1 1 1 1 1 1 1 1 1 1 1 1 1 1 10 10 10 10 10 10 10 10 10 10 10 10 10 10 10 10 10
0 0 0 0 0 0 0 0 0 0 0 0 2 2 2 2 1 1 1 1 1 1 1 1 1 1 1 1 1 1 1 1 1 10 10 10 10 10 10 10 10 10 10 10 10 10 10 10 10 10
0 0 0 0 0 0 0 0 0 0 0 2 2 2 2 1 1 1 1 1 1 1 1 1 1 1 1 1 1 1 1 1 1 10 10 10 10 10 10 10 10 10 10 10 10 10 10 10 10 10
0 0 0 0 0 0 0 0 0 0 0 2 2 2 2 2 1 1 1 1 1 1 1 1 1 1 1 1 1 1 8 1 1 8 10 10 10 10 10 10 10 10 10 10 10 10 0 0 0 0
0 0 0 0 0 0 0 0 0 0 0 2 2 2 2 2 1 1 1 1 1 1 1 1 1 1 1 1 1 8 1 8 8 8 8 10 10 10 10 10 10 10 10 10 10 10 0 0 0 0
0 0 0 0 0 0 0 0 0 0 2 2 2 2 1 1 1 1 1 1 1 1 1 1 1 1 1 1 8 8 8 8 8 8 8 8 10 10 10 10 0 0 10 10 10 10 10 0 0 0
0 0 0 0 0 0 0 0 0 0 9 2 2 1 1 1 1 1 1 1 1 1 1 1 1 1 1 8 8 8 8 8 8 8 8 8 10 10 0 0 0 0 10 10 10 10 10 10 0 0
9 9 9 9 0 0 0 0 0 0 9 9 9 1 1 1 1 1 1 1 1 1 0 0 0 0 0 8 8 8 8 8 8 8 0 0 0 0 0 0 0 0 0 10 10 10 10 10 0 0
9 9 9 9 9 9 9 9 9 9 9 9 9 9 9 9 9 9 9 0 0 0 0 0 0 0 0 0 0 0 8 8 8 0 0 0 0 0 0 0 0 0 0 0 10 10 10 10 0 0
9 9 9 9 9 9 9 9 9 9 9 9 9 9 9 9 9 9 9 0 0 0 0 0 0 0 0 0 0 0 0 0 0 0 0 0 0 0 0 0 0 0 0 0 10 10 10 10 10 0

1 0 0 255 300 0 0 0 5 -1 0 0 20 0 0 0 0 0 0 0 0 0 0
2 255 0 0 100 0 0 0 5 -1 0 0 20 0 0 0 0 0 0 0 0 0 0
3 0 255 0 90 0 0 0 5 -1 0 0 20 0 0 0 0 0 0 0 0 0 0
4 255 0 255 100 0 0 0 5 -1 0 0 20 0 0 0 0 0 0 0 0 0 0
5 255 255 0 80 0 0 0 5 -1 0 0 20 0 0 0 0 0 0 0 0 0 0
6 0 255 255 40 0 0 0 5 -1 0 0 20 0 0 0 0 0 0 0 0 0 0
7 100 0 0 80 0 0 0 5 -1 0 0 20 0 0 0 0 0 0 0 0 0 0
8 0 0 100 75 0 0 0 5 -1 0 0 20 0 0 0 0 0 0 0 0 0 0
9 0 100 0 50 0 0 0 5 -1 0 0 20 0 0 0 0 0 0 0 0 0 0
10 255 255 255 500 0 0 0 5 -1 0 0 75 0 4 7 0 0 0 0 0 0 0

-1 -1 -1 -1 -1 -1 -1 -1 3
42 -1 -1 -1 -1 -1 -1 -1 3
42 42 -1 -1 -1 -1 -1 -1 3
42 42 42 -1 -1 -1 -1 -1 3
42 42 42 42 -1 -1 -1 -1 3
42 42 42 42 42 -1 -1 -1 3
42 42 42 42 42 42 -1 -1 3
42 42 42 42 42 42 42 -1 3
42 42 42 42 42 42 42 42 -1
42 42 42 42 42 42 42 42 42

0 0 0 0 0 0 0 0 0 0
0 0 0 0 0 0 0 0 0 0
0 0 0 0 0 0 0 0 0 0
0 0 0 0 0 0 0 0 0 0
0 0 0 0 0 0 0 0 0 0
0 0 0 0 0 0 0 0 0 0

0 0 0
0 0 0 0 0 0 0 0 0 0
0 0 0 0 0 0 0 0 0 0 0 0 0 0 0 0 0 0 0 0 0 0 0 0 0 0 0 0 0 0 0 0 0 0 0 0 0 0 0 0 0 0 0 0 0 0 0 0 0 0 
0 0 0 0 0 0 0 0 0 0 0 0 0 0 0 0 0 0 0 0 0 0 0 0 0 0 0 0 0 0 0 0 0 0 0 0 0 0 0 0 0 0 0 0 0 0 0 0 0 0 
0 0 0 0 0 0 0 0 0 0 0 0 0 0 0 0 0 0 0 0 0 0 0 0 0 0 0 0 0 0 0 0 0 0 0 0 0 0 0 0 0 0 0 0 0 0 0 0 0 0 
0 0 0 0 0 0 0 0 0 0 0 0 0 0 0 0 0 0 0 0 0 0 0 0 0 0 0 0 0 0 0 0 0 0 0 0 0 0 0 0 0 0 0 0 0 0 0 0 0 0 
0 0 0 0 0 0 0 0 0 0 0 0 0 0 0 0 0 0 0 0 0 0 0 0 0 0 0 0 0 0 0 0 0 0 0 0 0 0 0 0 0 0 0 0 0 0 0 0 0 0 
0 0 0 0 0 0 0 0 0 0 0 0 0 0 0 0 0 0 0 0 0 0 0 0 0 0 0 0 0 0 0 0 0 0 0 0 0 0 0 0 0 0 0 0 0 0 0 0 0 0 
0 0 0 0 0 0 0 0 0 0 0 0 0 0 0 0 0 0 0 0 0 0 0 0 0 0 0 0 0 0 0 0 0 0 0 0 0 0 0 0 0 0 0 0 0 0 0 0 0 0 
0 0 0 0 0 0 0 0 0 0 0 0 0 0 0 0 0 0 0 0 0 0 0 0 0 0 0 0 0 0 0 0 0 0 0 0 0 0 0 0 0 0 0 0 0 0 0 0 0 0 
0 0 0 0 0 0 0 0 0 0 0 0 0 0 0 0 0 0 0 0 0 0 0 0 0 0 0 0 0 0 0 0 0 0 0 0 0 0 0 0 0 0 0 0 0 0 0 0 0 0 
0 0 0 0 0 0 0 0 0 0 0 0 0 0 0 0 0 0 0 0 0 0 0 0 0 0 0 0 0 0 0 0 0 0 0 0 0 0 0 0 0 0 0 0 0 0 0 0 0 0 
0 0 0 0 0 0 0 0 0 0 0 0 0 0 0 0 0 0 0 0 0 0 0 0 0 0 0 0 0 0 0 0 0 0 0 0 0 0 0 0 0 0 0 0 0 0 0 0 0 0 
0 0 0 0 0 0 0 0 0 0 0 0 0 0 0 0 0 0 0 0 0 0 0 0 0 0 0 0 0 0 0 0 0 0 0 0 0 0 0 0 0 0 0 0 0 0 0 0 0 0 
0 0 0 0 0 0 0 0 0 0 0 0 0 0 0 0 0 0 0 0 0 0 0 0 0 0 0 0 0 0 0 0 0 0 0 0 0 0 0 0 0 0 0 0 0 0 0 0 0 0 
0 0 0 0 0 0 0 0 0 0 0 0 0 0 0 0 0 0 0 0 0 0 0 0 0 0 0 0 0 0 0 0 0 0 0 0 0 0 0 0 0 0 0 0 0 0 0 0 0 0 
0 0 0 0 0 0 0 0 0 0 0 0 0 0 0 0 0 0 0 0 0 0 0 0 0 0 0 0 0 0 0 0 0 0 0 0 0 0 0 0 0 0 0 0 0 0 0 0 0 0 
0 0 0 0 0 0 0 0 0 0 0 0 0 0 0 0 0 0 0 0 0 0 0 0 0 0 0 0 0 0 0 0 0 0 0 0 0 0 0 0 0 0 0 0 0 0 0 0 0 0 
0 0 0 0 0 0 0 0 0 0 0 0 0 0 0 0 0 0 0 0 0 0 0 0 0 0 0 0 0 0 0 0 0 0 0 0 0 0 0 0 0 0 0 0 0 0 0 0 0 0 
0 0 0 0 0 0 0 0 0 0 0 0 0 0 0 0 0 0 0 0 0 0 0 0 0 0 0 0 0 0 0 0 0 0 0 0 0 0 0 0 0 0 0 0 0 0 0 0 0 0 
0 0 0 0 0 0 0 0 0 0 0 0 0 0 0 0 0 0 0 0 0 0 0 0 0 0 0 0 0 0 0 0 0 0 0 0 0 0 0 0 0 0 0 0 0 0 0 0 0 0 
0 0 0 0 0 0 0 0 0 0 0 0 0 0 0 0 0 0 0 0 0 0 0 0 0 0 0 0 0 0 0 0 0 0 0 0 0 0 0 0 0 0 0 0 0 0 0 0 0 0 
0 0 0 0 0 0 0 0 0 0 0 0 0 0 0 0 0 0 0 0 0 0 0 0 0 0 0 0 0 0 0 0 0 0 0 0 0 0 0 0 0 0 0 0 0 0 0 0 0 0 
0 0 0 0 0 0 0 0 0 0 0 0 0 0 0 0 0 0 0 0 0 0 0 0 0 0 0 0 0 0 0 0 0 0 0 0 0 0 0 0 0 0 0 0 0 0 0 0 0 0 
0 0 0 0 0 0 0 0 0 0 0 0 0 0 0 0 0 0 0 0 0 0 0 0 0 0 0 0 0 0 0 0 0 0 0 0 0 0 0 0 0 0 0 0 0 0 0 0 0 0 
0 0 0 0 0 0 0 0 0 0 0 0 0 0 0 0 0 0 0 0 0 0 0 0 0 0 0 0 0 0 0 0 0 0 0 0 0 0 0 0 0 0 0 0 0 0 0 0 0 0 
0 0 0 0 0 0 0 0 0 0 0 0 0 0 0 0 0 0 0 0 0 0 0 0 0 0 0 0 0 0 0 0 0 0 0 0 0 0 0 0 0 0 0 0 0 0 0 0 0 0 
0 0 0 0 0 0 0 0 0 0 0 0 0 0 0 0 0 0 0 0 0 0 0 0 0 0 0 0 0 0 0 0 0 0 0 0 0 0 0 0 0 0 0 0 0 0 0 0 0 0 
0 0 0 0 0 0 0 0 0 0 0 0 0 0 0 0 0 0 0 0 0 0 0 0 0 0 0 0 0 0 0 0 0 0 0 0 0 0 0 0 0 0 0 0 0 0 0 0 0 0 
0 0 0 0 0 0 0 0 0 0 0 0 0 0 0 0 0 0 0 0 0 0 0 0 0 0 0 0 0 0 0 0 0 0 0 0 0 0 0 0 0 0 0 0 0 0 0 0 0 0 
0 0 0 0 0 0 0 0 0 0 0 0 0 0 0 0 0 0 0 0 0 0 0 0 0 0 0 0 0 0 0 0 0 0 0 0 0 0 0 0 0 0 0 0 0 0 0 0 0 0 
0 0 0 0 0 0 0 0 0 0 0 0 0 0 0 0 0 0 0 0 0 0 0 0 0 0 0 0 0 0 0 0 0 0 0 0 0 0 0 0 0 0 0 0 0 0 0 0 0 0 

0.0 0.0 0.0 0.0 0.0 0.0 0.0 0.0 3.0
0.0 0.0 0.0 0.0 0.0 0.0 0.0 0.0 3.0
0.0 0.0 0.0 0.0 0.0 0.0 0.0 0.0 3.0
0.0 0.0 0.0 0.0 0.0 0.0 0.0 0.0 3.0
0.0 0.0 0.0 0.0 0.0 0.0 0.0 0.0 3.0
0.0 0.0 0.0 0.0 0.0 0.0 0.0 0.0 3.0
0.0 0.0 0.0 0.0 0.0 0.0 0.0 0.0 3.0
0.0 0.0 0.0 0.0 0.0 0.0 0.0 0.0 3.0
0.0 0.0 0.0 0.0 0.0 0.0 0.0 0.0 0.0
0.0 0.0 0.0 0.0 0.0 0.0 0.0 0.0 0.0
