16 2016
0 0 0 0 0 0 0 0 0 0 0 0 0 0 0 0 0 0 0 0 0 0 0 0 0 0 0 0 0 0 0 0 0 0 0 0 0 0 0 0 0 0 0 0 0 0 0 0 0 0
0 0 0 0 0 0 0 0 0 0 0 0 0 0 0 0 0 0 0 0 0 0 0 0 0 0 0 0 0 0 0 0 0 0 0 0 0 0 0 0 0 0 0 0 0 0 0 0 0 0
0 0 0 0 0 0 0 0 0 0 0 0 0 0 0 0 0 0 0 0 0 0 0 0 0 0 0 0 0 0 0 0 0 0 0 0 0 0 0 0 0 0 0 0 0 0 0 0 0 0
0 0 0 0 0 0 0 0 0 0 0 0 0 0 0 0 0 0 0 0 0 0 0 0 0 0 0 0 0 0 0 0 0 0 0 0 0 0 0 0 0 0 0 0 0 0 0 0 0 0
0 0 0 0 0 0 0 0 0 0 0 1 1 1 1 1 1 1 1 1 1 1 1 0 0 0 0 0 0 0 0 0 0 0 0 0 0 1 1 0 0 0 0 0 0 0 0 0 0 0
0 0 0 0 0 0 0 1 1 1 1 1 1 1 0 0 1 1 1 1 1 1 0 0 0 0 0 0 0 0 0 0 0 1 1 0 1 1 1 1 1 0 0 0 1 1 0 0 0 0
1 0 1 1 1 1 1 1 1 1 1 1 1 1 1 1 0 1 1 1 1 1 0 0 0 0 0 0 1 1 1 0 1 1 1 1 1 1 1 1 1 1 1 1 1 1 1 1 1 1
1 1 1 1 1 1 1 1 1 1 1 1 0 0 1 1 0 1 1 0 0 1 1 0 0 0 1 1 1 1 1 1 1 1 1 1 1 1 1 1 1 1 1 1 1 1 1 1 1 1
0 0 1 1 0 0 1 1 1 1 1 1 1 0 1 1 1 0 0 0 0 0 0 0 1 1 0 1 1 1 1 1 1 1 1 1 1 1 1 1 1 1 1 1 0 0 1 1 0 0
0 0 0 0 0 0 0 1 1 1 1 1 1 1 1 1 1 1 0 0 0 0 0 0 1 1 1 1 1 1 1 1 1 1 1 1 1 1 1 1 1 1 1 1 1 0 1 0 0 0
0 0 0 0 0 0 0 0 1 1 1 1 1 1 1 1 0 0 0 0 0 0 0 0 0 1 1 1 1 1 1 1 1 1 1 1 1 1 1 1 1 1 1 1 1 0 0 0 0 0
0 0 0 0 0 0 0 0 1 1 1 1 1 1 1 0 0 0 0 0 0 0 0 0 1 1 0 1 1 1 1 1 1 1 1 1 1 1 1 1 1 1 1 0 1 0 0 0 0 0
0 0 0 0 0 0 0 0 1 1 1 1 1 1 0 0 0 0 0 0 0 0 0 0 1 1 1 0 0 0 1 1 1 1 1 1 1 1 1 1 1 1 0 1 1 0 0 0 0 0
0 0 0 0 0 0 0 0 0 1 1 0 0 1 0 0 0 0 0 0 0 0 0 0 1 1 1 1 1 1 1 1 1 1 1 1 1 1 1 1 1 1 0 0 0 0 0 0 0 0
0 0 0 0 0 0 0 0 0 0 1 1 1 0 0 0 0 0 0 0 0 0 0 1 1 1 1 1 1 1 1 1 1 1 0 1 1 1 1 1 1 0 0 0 0 0 0 0 0 0
0 0 0 0 0 0 0 0 0 0 0 1 1 1 0 0 0 0 0 0 0 0 0 1 1 1 1 1 1 1 1 1 1 0 0 1 1 0 1 1 1 0 1 0 0 0 0 0 0 0
0 0 0 0 0 0 0 0 0 0 0 0 0 1 1 1 1 0 0 0 0 0 0 0 1 1 1 1 1 1 1 1 1 0 0 0 1 0 0 1 0 1 1 0 0 0 0 0 0 0
0 0 0 0 0 0 0 0 0 0 0 0 0 1 1 1 1 1 0 0 0 0 0 0 0 0 1 1 1 1 1 1 0 0 0 0 0 0 1 1 1 1 0 0 0 0 0 0 0 0
0 0 0 0 0 0 0 0 0 0 0 0 0 1 1 1 1 1 1 1 0 0 0 0 0 0 0 1 1 1 1 0 0 0 0 0 0 0 0 1 1 1 1 0 1 1 0 0 0 0
0 0 0 0 0 0 0 0 0 0 0 0 0 1 1 1 1 1 1 1 0 0 0 0 0 0 0 1 1 1 1 0 0 0 0 0 0 0 0 0 1 0 1 1 1 1 0 0 0 0
0 0 0 0 0 0 0 0 0 0 0 0 0 0 1 1 1 1 1 0 0 0 0 0 0 0 0 1 1 1 1 1 0 0 0 0 0 0 0 0 0 0 1 1 1 1 0 0 0 0
0 0 0 0 0 0 0 0 0 0 0 0 0 0 0 1 1 1 1 0 0 0 0 0 0 0 0 1 1 1 0 1 0 0 0 0 0 0 0 0 0 1 1 1 1 1 0 0 0 0
0 0 0 0 0 0 0 0 0 0 0 0 0 0 0 1 1 1 0 0 0 0 0 0 0 0 0 0 1 1 0 0 0 0 0 0 0 0 0 0 0 1 1 1 1 1 1 0 0 0
0 0 0 0 0 0 0 0 0 0 0 0 0 0 0 1 1 0 0 0 0 0 0 0 0 0 0 0 1 0 0 0 0 0 0 0 0 0 0 0 0 1 1 1 1 1 1 0 0 0
0 0 0 0 0 0 0 0 0 0 0 0 0 0 1 1 1 0 0 0 0 0 0 0 0 0 0 0 0 0 0 0 0 0 0 0 0 0 0 0 0 0 0 0 0 1 0 0 0 0
0 0 0 0 0 0 0 0 0 0 0 0 0 0 1 1 0 0 0 0 0 0 0 0 0 0 0 0 0 0 0 0 0 0 0 0 0 0 0 0 0 0 0 0 0 0 0 0 0 0
0 0 0 0 0 0 0 0 0 0 0 0 0 0 1 0 0 0 0 0 0 0 0 0 0 0 0 0 0 0 0 0 0 0 0 0 0 0 0 0 0 0 0 0 0 0 0 0 0 0
0 0 0 0 0 0 0 0 0 0 0 0 0 0 0 0 0 0 0 0 0 0 0 0 0 0 0 0 0 0 0 0 0 0 0 0 0 0 0 0 0 0 0 0 0 0 0 0 0 0
0 0 0 0 0 0 0 0 0 0 0 0 0 0 0 0 0 0 0 0 0 0 0 0 0 0 0 0 0 0 0 0 0 0 0 0 0 0 0 0 0 0 0 0 0 0 0 0 0 0
0 0 0 0 0 0 0 0 0 0 0 0 0 0 0 0 0 0 0 0 0 0 0 0 0 0 0 0 0 0 0 0 0 0 0 0 0 0 0 0 0 0 0 0 0 0 0 0 0 0

0 0 0 0 0 0 0 0 0 0 0 0 0 0 0 0 0 0 0 0 0 0 0 0 0 0 0 0 0 0 0 0 0 0 0 0 0 0 0 0 0 0 0 0 0 0 0 0 0 0
0 0 0 0 0 0 0 0 0 0 0 0 0 0 0 0 0 0 0 0 0 0 0 0 0 0 0 0 0 0 0 0 0 0 0 0 0 0 0 0 0 0 0 0 0 0 0 0 0 0
0 0 0 0 0 0 0 0 0 0 0 0 0 0 0 0 0 0 0 0 0 0 0 0 0 0 0 0 0 0 0 0 0 0 0 0 0 0 0 0 0 0 0 0 0 0 0 0 0 0
0 0 0 0 0 0 0 0 0 0 0 0 0 0 0 0 0 0 0 0 0 0 0 0 0 0 0 0 0 0 0 0 0 0 0 0 0 0 0 0 0 0 0 0 0 0 0 0 0 0
0 0 0 0 0 0 0 0 0 0 0 3 3 3 3 3 3 3 3 3 3 3 3 0 0 0 0 0 0 0 0 0 0 0 0 0 0 6 6 0 0 0 0 0 0 0 0 0 0 0
0 0 0 0 0 0 0 4 4 4 5 3 3 5 0 0 3 2 2 2 2 3 0 0 0 0 0 0 0 0 0 0 0 6 6 0 6 4 4 6 6 0 0 0 6 6 0 0 0 0
4 0 4 4 4 4 4 4 4 4 4 3 5 5 3 5 0 3 2 3 3 3 0 0 0 0 0 0 6 6 6 0 6 4 4 6 4 4 4 4 4 6 6 6 4 4 6 6 6 6
4 4 2 2 4 4 4 4 4 4 4 4 0 0 5 5 0 3 3 0 0 5 5 0 0 0 7 7 4 4 4 6 4 4 4 4 4 4 4 4 4 4 4 4 4 4 4 4 6 6
0 0 4 4 0 0 6 4 4 4 4 4 4 0 5 3 5 0 0 0 0 0 0 0 7 7 0 7 4 4 4 4 4 4 4 4 4 4 4 4 4 4 4 6 0 0 6 6 0 0
0 0 0 0 0 0 0 6 5 4 4 4 4 4 4 4 6 6 0 0 0 0 0 0 7 5 5 5 5 4 4 4 4 4 4 4 4 4 4 4 4 4 4 4 6 0 6 0 0 0
0 0 0 0 0 0 0 0 7 4 4 4 4 1 4 6 0 0 0 0 0 0 0 0 0 7 7 5 5 5 5 5 5 5 5 5 5 5 5 6 6 6 3 3 5 0 0 0 0 0
0 0 0 0 0 0 0 0 6 5 4 4 4 4 5 0 0 0 0 0 0 0 0 0 7 7 0 7 7 7 5 5 5 5 5 5 5 5 4 5 6 6 7 0 5 0 0 0 0 0
0 0 0 0 0 0 0 0 6 5 4 4 4 5 0 0 0 0 0 0 0 0 0 0 7 5 7 0 0 0 5 5 5 5 5 4 4 4 4 4 6 7 0 5 5 0 0 0 0 0
0 0 0 0 0 0 0 0 0 6 7 0 0 5 0 0 0 0 0 0 0 0 0 0 9 7 7 3 3 3 2 2 5 5 7 5 5 4 4 4 6 7 0 0 0 0 0 0 0 0
0 0 0 0 0 0 0 0 0 0 8 8 8 0 0 0 0 0 0 0 0 0 0 5 2 2 2 2 2 2 2 2 3 5 0 7 5 7 4 6 7 0 0 0 0 0 0 0 0 0
0 0 0 0 0 0 0 0 0 0 0 8 6 6 0 0 0 0 0 0 0 0 0 5 2 2 2 2 2 2 2 3 5 0 0 7 5 0 6 6 7 0 7 0 0 0 0 0 0 0
0 0 0 0 0 0 0 0 0 0 0 0 0 8 9 9 5 0 0 0 0 0 0 0 6 6 4 2 2 2 2 3 5 0 0 0 7 0 0 6 0 7 7 0 0 0 0 0 0 0
0 0 0 0 0 0 0 0 0 0 0 0 0 8 6 4 4 5 0 0 0 0 0 0 0 0 7 4 4 3 2 4 0 0 0 0 0 0 5 6 7 7 0 0 0 0 0 0 0 0
0 0 0 0 0 0 0 0 0 0 0 0 0 8 4 4 4 4 8 8 0 0 0 0 0 0 0 6 4 4 5 0 0 0 0 0 0 0 0 8 6 5 7 0 7 7 0 0 0 0
0 0 0 0 0 0 0 0 0 0 0 0 0 5 4 4 4 6 6 8 0 0 0 0 0 0 0 6 4 4 9 0 0 0 0 0 0 0 0 0 8 0 7 7 5 7 0 0 0 0
0 0 0 0 0 0 0 0 0 0 0 0 0 0 5 4 4 6 8 0 0 0 0 0 0 0 0 6 6 6 8 8 0 0 0 0 0 0 0 0 0 0 8 5 5 8 0 0 0 0
0 0 0 0 0 0 0 0 0 0 0 0 0 0 0 5 6 6 8 0 0 0 0 0 0 0 0 6 6 8 0 8 0 0 0 0 0 0 0 0 0 8 6 6 2 8 0 0 0 0
0 0 0 0 0 0 0 0 0 0 0 0 0 0 0 8 6 8 0 0 0 0 0 0 0 0 0 0 7 8 0 0 0 0 0 0 0 0 0 0 0 7 6 6 2 6 8 0 0 0
0 0 0 0 0 0 0 0 0 0 0 0 0 0 0 8 8 0 0 0 0 0 0 0 0 0 0 0 8 0 0 0 0 0 0 0 0 0 0 0 0 7 7 8 7 5 7 0 0 0
0 0 0 0 0 0 0 0 0 0 0 0 0 0 8 8 8 0 0 0 0 0 0 0 0 0 0 0 0 0 0 0 0 0 0 0 0 0 0 0 0 0 0 0 0 7 0 0 0 0
0 0 0 0 0 0 0 0 0 0 0 0 0 0 7 8 0 0 0 0 0 0 0 0 0 0 0 0 0 0 0 0 0 0 0 0 0 0 0 0 0 0 0 0 0 0 0 0 0 0
0 0 0 0 0 0 0 0 0 0 0 0 0 0 7 0 0 0 0 0 0 0 0 0 0 0 0 0 0 0 0 0 0 0 0 0 0 0 0 0 0 0 0 0 0 0 0 0 0 0
0 0 0 0 0 0 0 0 0 0 0 0 0 0 0 0 0 0 0 0 0 0 0 0 0 0 0 0 0 0 0 0 0 0 0 0 0 0 0 0 0 0 0 0 0 0 0 0 0 0
0 0 0 0 0 0 0 0 0 0 0 0 0 0 0 0 0 0 0 0 0 0 0 0 0 0 0 0 0 0 0 0 0 0 0 0 0 0 0 0 0 0 0 0 0 0 0 0 0 0
0 0 0 0 0 0 0 0 0 0 0 0 0 0 0 0 0 0 0 0 0 0 0 0 0 0 0 0 0 0 0 0 0 0 0 0 0 0 0 0 0 0 0 0 0 0 0 0 0 0

0 0 0 0 0 0 0 0 0 0 0 0 0 0 0 0 0 0 0 0 0 0 0 0 0 0 0 0 0 0 0 0 0 0 0 0 0 0 0 0 0 0 0 0 0 0 0 0 0 0
0 0 0 0 0 0 0 0 0 0 0 0 0 0 0 0 0 0 0 0 0 0 0 0 0 0 0 0 0 0 0 0 0 0 0 0 0 0 0 0 0 0 0 0 0 0 0 0 0 0
0 0 0 0 0 0 0 0 0 0 0 0 0 0 0 0 0 0 0 0 0 0 0 0 0 0 0 0 0 0 0 0 0 0 0 0 0 0 0 0 0 0 0 0 0 0 0 0 0 0
0 0 0 0 0 0 0 0 0 0 0 0 0 0 0 0 0 0 0 0 0 0 0 0 0 0 0 0 0 0 0 0 0 0 0 0 0 0 0 0 0 0 0 0 0 0 0 0 0 0
0 0 0 0 0 0 0 0 0 0 0 9 9 9 9 2 2 2 2 2 2 2 2 0 0 0 0 0 0 0 0 0 0 0 0 0 0 7 7 0 0 0 0 0 0 0 0 0 0 0
0 0 0 0 0 0 0 9 9 9 9 8 8 9 0 0 2 1 1 1 1 2 0 0 0 0 0 0 0 0 0 0 0 7 7 0 7 6 6 7 7 0 0 0 7 7 0 0 0 0
7 0 9 9 9 9 9 8 8 8 8 8 9 8 9 9 0 2 1 2 2 2 0 0 0 0 0 0 6 6 7 0 7 6 6 6 6 6 6 6 6 7 7 7 6 6 7 7 7 7
7 9 8 8 9 9 8 8 8 8 8 9 0 0 9 9 0 2 2 0 0 5 5 0 0 0 6 6 6 6 6 6 6 6 6 6 6 6 6 6 6 6 6 6 7 7 6 6 7 7
0 0 9 9 0 0 9 8 8 8 8 8 9 0 9 8 9 0 0 0 0 0 0 0 6 6 0 6 5 5 6 6 6 6 6 6 6 6 6 6 6 6 6 7 0 0 7 7 0 0
0 0 0 0 0 0 0 9 8 8 8 8 8 9 8 8 9 9 0 0 0 0 0 0 6 5 6 5 5 5 6 6 6 6 6 6 6 6 6 6 6 6 6 6 8 0 7 0 0 0
0 0 0 0 0 0 0 0 9 8 8 8 8 8 8 9 0 0 0 0 0 0 0 0 0 6 6 5 5 6 6 6 6 6 6 6 6 6 6 6 6 6 6 7 8 0 0 0 0 0
0 0 0 0 0 0 0 0 9 8 8 8 8 8 9 0 0 0 0 0 0 0 0 0 6 6 0 6 6 6 6 6 6 6 5 6 6 6 6 6 6 6 8 0 8 0 0 0 0 0
0 0 0 0 0 0 0 0 9 8 8 9 9 9 0 0 0 0 0 0 0 0 0 0 5 4 5 0 0 0 6 6 6 6 5 5 6 6 6 6 6 7 0 8 8 0 0 0 0 0
0 0 0 0 0 0 0 0 0 8 8 0 0 9 0 0 0 0 0 0 0 0 0 0 5 4 4 5 5 5 5 5 6 6 6 5 5 5 5 6 6 7 0 0 0 0 0 0 0 0
0 0 0 0 0 0 0 0 0 0 8 4 4 0 0 0 0 0 0 0 0 0 0 3 4 4 2 2 3 3 3 5 5 6 0 6 5 6 5 5 7 0 0 0 0 0 0 0 0 0
0 0 0 0 0 0 0 0 0 0 0 4 4 3 0 0 0 0 0 0 0 0 0 4 3 3 3 3 3 3 3 5 6 0 0 6 6 0 6 6 6 0 1 0 0 0 0 0 0 0
0 0 0 0 0 0 0 0 0 0 0 0 0 4 4 3 4 0 0 0 0 0 0 0 4 4 3 4 3 3 3 3 4 0 0 0 6 0 0 6 0 1 1 0 0 0 0 0 0 0
0 0 0 0 0 0 0 0 0 0 0 0 0 4 3 3 3 4 0 0 0 0 0 0 0 0 4 4 3 3 3 4 0 0 0 0 0 0 7 6 1 1 0 0 0 0 0 0 0 0
0 0 0 0 0 0 0 0 0 0 0 0 0 4 3 3 3 3 4 4 0 0 0 0 0 0 0 3 2 3 4 0 0 0 0 0 0 0 0 7 6 7 7 0 7 7 0 0 0 0
0 0 0 0 0 0 0 0 0 0 0 0 0 5 2 2 3 3 3 4 0 0 0 0 0 0 0 5 2 3 4 0 0 0 0 0 0 0 0 0 7 0 7 7 7 8 0 0 0 0
0 0 0 0 0 0 0 0 0 0 0 0 0 0 4 2 3 3 4 0 0 0 0 0 0 0 0 5 3 3 4 4 0 0 0 0 0 0 0 0 0 0 8 7 7 8 0 0 0 0
0 0 0 0 0 0 0 0 0 0 0 0 0 0 0 4 3 3 4 0 0 0 0 0 0 0 0 6 5 4 0 4 0 0 0 0 0 0 0 0 0 8 7 7 7 8 0 0 0 0
0 0 0 0 0 0 0 0 0 0 0 0 0 0 0 4 3 4 0 0 0 0 0 0 0 0 0 0 6 6 0 0 0 0 0 0 0 0 0 0 0 8 7 7 7 7 8 0 0 0
0 0 0 0 0 0 0 0 0 0 0 0 0 0 0 4 4 0 0 0 0 0 0 0 0 0 0 0 6 0 0 0 0 0 0 0 0 0 0 0 0 8 8 8 8 7 8 0 0 0
0 0 0 0 0 0 0 0 0 0 0 0 0 0 4 3 4 0 0 0 0 0 0 0 0 0 0 0 0 0 0 0 0 0 0 0 0 0 0 0 0 0 0 0 0 8 0 0 0 0
0 0 0 0 0 0 0 0 0 0 0 0 0 0 4 4 0 0 0 0 0 0 0 0 0 0 0 0 0 0 0 0 0 0 0 0 0 0 0 0 0 0 0 0 0 0 0 0 0 0
0 0 0 0 0 0 0 0 0 0 0 0 0 0 4 0 0 0 0 0 0 0 0 0 0 0 0 0 0 0 0 0 0 0 0 0 0 0 0 0 0 0 0 0 0 0 0 0 0 0
0 0 0 0 0 0 0 0 0 0 0 0 0 0 0 0 0 0 0 0 0 0 0 0 0 0 0 0 0 0 0 0 0 0 0 0 0 0 0 0 0 0 0 0 0 0 0 0 0 0
0 0 0 0 0 0 0 0 0 0 0 0 0 0 0 0 0 0 0 0 0 0 0 0 0 0 0 0 0 0 0 0 0 0 0 0 0 0 0 0 0 0 0 0 0 0 0 0 0 0
0 0 0 0 0 0 0 0 0 0 0 0 0 0 0 0 0 0 0 0 0 0 0 0 0 0 0 0 0 0 0 0 0 0 0 0 0 0 0 0 0 0 0 0 0 0 0 0 0 0

0 0 0 0 0 0 0 0 0 0 0 0 0 0 0 0 0 0 0 0 0 0 0 0 0 0 0 0 0 0 0 0 0 0 0 0 0 0 0 0 0 0 0 0 0 0 0 0 0 0
0 0 0 0 0 0 0 0 0 0 0 0 0 0 0 0 0 0 0 0 0 0 0 0 0 0 0 0 0 0 0 0 0 0 0 0 0 0 0 0 0 0 0 0 0 0 0 0 0 0
0 0 0 0 0 0 0 0 0 0 0 0 0 0 0 0 0 0 0 0 0 0 0 0 0 0 0 0 0 0 0 0 0 0 0 0 0 0 0 0 0 0 0 0 0 0 0 0 0 0
0 0 0 0 0 0 0 0 0 0 0 0 0 0 0 0 0 0 0 0 0 0 0 0 0 0 0 0 0 0 0 0 0 0 0 0 0 0 0 0 0 0 0 0 0 0 0 0 0 0
0 0 0 0 0 0 0 0 0 0 0 1 1 1 1 1 1 1 0 0 0 0 0 0 0 0 0 0 0 0 0 0 0 0 0 0 0 2 2 0 0 0 0 0 0 0 0 0 0 0
0 0 0 0 0 0 0 1 1 1 1 1 1 1 0 0 1 1 1 0 0 0 0 0 0 0 0 0 0 0 0 0 0 2 2 0 2 2 2 2 2 0 0 0 2 2 0 0 0 0
2 0 1 1 1 1 1 1 1 1 1 1 1 1 1 1 0 1 1 1 0 0 0 0 0 0 0 0 3 3 3 0 2 2 2 2 2 2 2 2 2 2 2 2 2 2 2 2 2 2
2 1 1 1 1 1 1 1 1 1 1 1 0 0 1 1 0 1 1 0 0 3 3 0 0 0 3 3 3 3 3 2 2 2 2 2 2 2 2 2 2 2 2 2 2 2 2 2 2 2
0 0 1 1 0 0 1 1 1 1 1 1 1 0 1 1 1 0 0 0 0 0 0 0 3 3 0 3 3 3 3 3 2 2 2 2 2 2 2 2 2 2 2 2 0 0 2 2 0 0
0 0 0 0 0 0 0 1 1 1 1 1 1 1 1 1 1 1 0 0 0 0 0 0 3 3 3 3 3 3 3 3 2 2 2 2 2 2 2 2 2 2 2 2 2 0 2 0 0 0
0 0 0 0 0 0 0 0 1 1 1 1 1 1 1 1 0 0 0 0 0 0 0 0 0 3 3 3 3 3 3 2 2 2 6 6 6 2 6 6 6 6 2 2 2 0 0 0 0 0
0 0 0 0 0 0 0 0 1 1 1 1 1 1 1 0 0 0 0 0 0 0 0 0 3 3 0 3 3 3 16 16 16 16 6 6 6 6 6 6 6 6 5 0 4 0 0 0 0 0
0 0 0 0 0 0 0 0 1 1 1 1 1 1 0 0 0 0 0 0 0 0 0 0 15 15 15 0 0 0 13 16 16 16 6 7 6 6 6 6 6 6 0 4 4 0 0 0 0 0
0 0 0 0 0 0 0 0 0 1 1 0 0 1 0 0 0 0 0 0 0 0 0 0 15 15 15 15 15 15 16 16 16 16 7 7 7 7 6 6 6 6 0 0 0 0 0 0 0 0
0 0 0 0 0 0 0 0 0 0 9 9 9 0 0 0 0 0 0 0 0 0 0 15 15 15 15 15 15 15 15 16 16 16 0 7 7 7 6 6 6 0 0 0 0 0 0 0 0 0
0 0 0 0 0 0 0 0 0 0 0 9 9 9 0 0 0 0 0 0 0 0 0 14 14 14 14 14 14 14 14 14 14 0 0 7 7 0 12 12 12 0 12 0 0 0 0 0 0 0
0 0 0 0 0 0 0 0 0 0 0 0 0 9 9 9 8 0 0 0 0 0 0 0 14 14 14 14 14 14 14 14 14 0 0 0 7 0 0 12 0 12 12 0 0 0 0 0 0 0
0 0 0 0 0 0 0 0 0 0 0 0 0 9 8 8 8 8 0 0 0 0 0 0 0 0 14 14 14 14 14 14 0 0 0 0 0 0 12 12 12 12 0 0 0 0 0 0 0 0
0 0 0 0 0 0 0 0 0 0 0 0 0 9 8 8 8 8 8 8 0 0 0 0 0 0 0 14 14 14 14 0 0 0 0 0 0 0 0 12 12 12 12 0 12 12 0 0 0 0
0 0 0 0 0 0 0 0 0 0 0 0 0 9 9 8 8 8 8 8 0 0 0 0 0 0 0 10 14 14 10 0 0 0 0 0 0 0 0 0 12 0 12 12 12 12 0 0 0 0
0 0 0 0 0 0 0 0 0 0 0 0 0 0 9 9 8 8 8 0 0 0 0 0 0 0 0 10 10 10 10 10 0 0 0 0 0 0 0 0 0 0 12 12 12 11 0 0 0 0
0 0 0 0 0 0 0 0 0 0 0 0 0 0 0 9 8 8 8 0 0 0 0 0 0 0 0 10 10 10 0 10 0 0 0 0 0 0 0 0 0 11 11 11 11 11 0 0 0 0
0 0 0 0 0 0 0 0 0 0 0 0 0 0 0 9 8 8 0 0 0 0 0 0 0 0 0 0 10 10 0 0 0 0 0 0 0 0 0 0 0 11 11 11 11 11 11 0 0 0
0 0 0 0 0 0 0 0 0 0 0 0 0 0 0 9 8 0 0 0 0 0 0 0 0 0 0 0 10 0 0 0 0 0 0 0 0 0 0 0 0 11 11 11 11 11 11 0 0 0
0 0 0 0 0 0 0 0 0 0 0 0 0 0 9 9 9 0 0 0 0 0 0 0 0 0 0 0 0 0 0 0 0 0 0 0 0 0 0 0 0 0 0 0 0 11 0 0 0 0
0 0 0 0 0 0 0 0 0 0 0 0 0 0 9 9 0 0 0 0 0 0 0 0 0 0 0 0 0 0 0 0 0 0 0 0 0 0 0 0 0 0 0 0 0 0 0 0 0 0
0 0 0 0 0 0 0 0 0 0 0 0 0 0 9 0 0 0 0 0 0 0 0 0 0 0 0 0 0 0 0 0 0 0 0 0 0 0 0 0 0 0 0 0 0 0 0 0 0 0
0 0 0 0 0 0 0 0 0 0 0 0 0 0 0 0 0 0 0 0 0 0 0 0 0 0 0 0 0 0 0 0 0 0 0 0 0 0 0 0 0 0 0 0 0 0 0 0 0 0
0 0 0 0 0 0 0 0 0 0 0 0 0 0 0 0 0 0 0 0 0 0 0 0 0 0 0 0 0 0 0 0 0 0 0 0 0 0 0 0 0 0 0 0 0 0 0 0 0 0
0 0 0 0 0 0 0 0 0 0 0 0 0 0 0 0 0 0 0 0 0 0 0 0 0 0 0 0 0 0 0 0 0 0 0 0 0 0 0 0 0 0 0 0 0 0 0 0 0 0

1 0 102 0 90 0 0 0 0 9 0 0 200 0 8 5 0 0 0 0 0 0 0 
2 255 0 0 38 0 0 0 0 8 0 0 160 0 6 8 0 0 0 0 0 0 0 
3 0 0 102 142 0 0 0 0 9 0 0 160 0 9 2 0 0 0 0 0 0 0 
4 0 204 204 46 0 0 0 0 9 0 0 190 0 9 2 0 0 0 0 0 0 0 
5 255 128 0 6 0 0 0 0 4 0 0 140 0 0 7 0 0 0 0 0 0 0 
6 255 255 0 344 0 0 0 0 8 0 0 150 0 4 5 0 0 0 0 0 0 0 
7 153 255 51 284 0 0 0 0 8 0 0 130 0 7 3 0 0 0 0 0 0 0 
8 0 76 153 49 0 0 0 0 8 0 0 130 0 7 3 0 0 0 0 0 0 0 
9 102 51 0 75 0 0 0 0 7 0 0 110 0 7 3 0 0 0 0 0 0 0 
10 0 255 0 40 0 0 0 0 8 0 0 120 0 7 2 0 0 0 0 0 0 0 
11 102 0 102 6 0 0 0 0 9 0 0 160 0 8 3 0 0 0 0 0 0 0 
12 76 0 153 125 0 0 0 0 7 0 0 100 0 7 3 0 0 0 0 0 0 0 
13 51 0 0 1 0 0 0 0 1 0 0 140 0 0 9 0 0 0 0 0 0 0 
14 255 255 255 121 0 0 0 0 7 0 0 100 0 4 3 0 0 0 0 0 0 0 
15 255 51 255 51 0 0 0 0 7 0 0 110 0 5 3 0 0 0 0 0 0 0 
16 153 0 76 101 0 0 0 0 7 0 0 120 0 4 4 0 0 0 0 0 0 0 

4 6 -1 -1 -1 -1 -1 5 -1 -1 -1 -1 -1 -1 -1
42 5 5 4 5 -1 -1 -1 -1 -1 -1 -1 -1 -1 4
42 42 -1 -1 -1 -1 -1 -1 -1 -1 -1 -1 -1 5 5
42 42 42 -1 -1 -1 -1 -1 -1 -1 -1 -1 -1 -1 -1
42 42 42 42 4 -1 -1 -1 -1 -1 -1 -1 -1 -1 -1
42 42 42 42 42 5 -1 -1 -1 -1 5 -1 -1 -1 4
42 42 42 42 42 42 -1 -1 -1 -1 -1 -1 -1 -1 4
42 42 42 42 42 42 42 6 -1 -1 -1 -1 -1 -1 -1
42 42 42 42 42 42 42 42 -1 -1 -1 -1 -1 -1 -1
42 42 42 42 42 42 42 42 42 -1 -1 -1 4 -1 -1
42 42 42 42 42 42 42 42 42 42 5 -1 -1 -1 -1
42 42 42 42 42 42 42 42 42 42 42 -1 -1 -1 -1
42 42 42 42 42 42 42 42 42 42 42 42 -1 -1 4
42 42 42 42 42 42 42 42 42 42 42 42 42 4 4
42 42 42 42 42 42 42 42 42 42 42 42 42 42 4
42 42 42 42 42 42 42 42 42 42 42 42 42 42 42

0 0 0 0 0 0 0 0 0 0 0 0 0 0 0 0 
0 0 0 0 0 0 0 0 0 0 0 0 0 0 0 0 
0 0 0 0 0 0 0 0 0 0 0 0 0 0 0 0 
0 0 0 0 0 0 0 0 0 0 0 0 0 0 0 0 
0 0 0 0 0 0 0 0 0 0 0 0 0 0 0 0 
0 0 0 0 0 0 0 0 0 0 0 0 0 0 0 0 

0 0 0 
0 0 0 0 0 0 0 0 0 0 0 0 0 0 0 0 
0 0 0 0 0 0 0 0 0 0 0 0 0 0 0 0 0 0 0 0 0 0 0 0 0 0 0 0 0 0 0 0 0 0 0 0 0 0 0 0 0 0 0 0 0 0 0 0 0 0 
0 0 0 0 0 0 0 0 0 0 0 0 0 0 0 0 0 0 0 0 0 0 0 0 0 0 0 0 0 0 0 0 0 0 0 0 0 0 0 0 0 0 0 0 0 0 0 0 0 0 
0 0 0 0 0 0 0 0 0 0 0 0 0 0 0 0 0 0 0 0 0 0 0 0 0 0 0 0 0 0 0 0 0 0 0 0 0 0 0 0 0 0 0 0 0 0 0 0 0 0 
0 0 0 0 0 0 0 0 0 0 0 0 0 0 0 0 0 0 0 0 0 0 0 0 0 0 0 0 0 0 0 0 0 0 0 0 0 0 0 0 0 0 0 0 0 0 0 0 0 0 
0 0 0 0 0 0 0 0 0 0 0 0 0 0 0 0 0 0 0 0 0 0 0 0 0 0 0 0 0 0 0 0 0 0 0 0 0 0 0 0 0 0 0 0 0 0 0 0 0 0 
0 0 0 0 0 0 0 0 0 0 0 0 0 0 0 0 0 0 0 0 0 0 0 0 0 0 0 0 0 0 0 0 0 0 0 0 0 0 0 0 0 0 0 0 0 0 0 0 0 0 
0 0 0 0 0 0 0 0 0 0 0 0 0 0 0 0 0 0 0 0 0 0 0 0 0 0 0 0 0 0 0 0 0 0 0 0 0 0 0 0 0 0 0 0 0 0 0 0 0 0 
0 0 0 0 0 0 0 0 0 0 0 0 0 0 0 0 0 0 0 0 0 0 0 0 0 0 0 0 0 0 0 0 0 0 0 0 0 0 0 0 0 0 0 0 0 0 0 0 0 0 
0 0 0 0 0 0 0 0 0 0 0 0 0 0 0 0 0 0 0 0 0 0 0 0 0 0 0 0 0 0 0 0 0 0 0 0 0 0 0 0 0 0 0 0 0 0 0 0 0 0 
0 0 0 0 0 0 0 0 0 0 0 0 0 0 0 0 0 0 0 0 0 0 0 0 0 0 0 0 0 0 0 0 0 0 0 0 0 0 0 0 0 0 0 0 0 0 0 0 0 0 
0 0 0 0 0 0 0 0 0 0 0 0 0 0 0 0 0 0 0 0 0 0 0 0 0 0 0 0 0 0 0 0 0 0 0 0 0 0 0 0 0 0 0 0 0 0 0 0 0 0 
0 0 0 0 0 0 0 0 0 0 0 0 0 0 0 0 0 0 0 0 0 0 0 0 0 0 0 0 0 0 0 0 0 0 0 0 0 0 0 0 0 0 0 0 0 0 0 0 0 0 
0 0 0 0 0 0 0 0 0 0 0 0 0 0 0 0 0 0 0 0 0 0 0 0 0 0 0 0 0 0 0 0 0 0 0 0 0 0 0 0 0 0 0 0 0 0 0 0 0 0 
0 0 0 0 0 0 0 0 0 0 0 0 0 0 0 0 0 0 0 0 0 0 0 0 0 0 0 0 0 0 0 0 0 0 0 0 0 0 0 0 0 0 0 0 0 0 0 0 0 0 
0 0 0 0 0 0 0 0 0 0 0 0 0 0 0 0 0 0 0 0 0 0 0 0 0 0 0 0 0 0 0 0 0 0 0 0 0 0 0 0 0 0 0 0 0 0 0 0 0 0 
0 0 0 0 0 0 0 0 0 0 0 0 0 0 0 0 0 0 0 0 0 0 0 0 0 0 0 0 0 0 0 0 0 0 0 0 0 0 0 0 0 0 0 0 0 0 0 0 0 0 
0 0 0 0 0 0 0 0 0 0 0 0 0 0 0 0 0 0 0 0 0 0 0 0 0 0 0 0 0 0 0 0 0 0 0 0 0 0 0 0 0 0 0 0 0 0 0 0 0 0 
0 0 0 0 0 0 0 0 0 0 0 0 0 0 0 0 0 0 0 0 0 0 0 0 0 0 0 0 0 0 0 0 0 0 0 0 0 0 0 0 0 0 0 0 0 0 0 0 0 0 
0 0 0 0 0 0 0 0 0 0 0 0 0 0 0 0 0 0 0 0 0 0 0 0 0 0 0 0 0 0 0 0 0 0 0 0 0 0 0 0 0 0 0 0 0 0 0 0 0 0 
0 0 0 0 0 0 0 0 0 0 0 0 0 0 0 0 0 0 0 0 0 0 0 0 0 0 0 0 0 0 0 0 0 0 0 0 0 0 0 0 0 0 0 0 0 0 0 0 0 0 
0 0 0 0 0 0 0 0 0 0 0 0 0 0 0 0 0 0 0 0 0 0 0 0 0 0 0 0 0 0 0 0 0 0 0 0 0 0 0 0 0 0 0 0 0 0 0 0 0 0 
0 0 0 0 0 0 0 0 0 0 0 0 0 0 0 0 0 0 0 0 0 0 0 0 0 0 0 0 0 0 0 0 0 0 0 0 0 0 0 0 0 0 0 0 0 0 0 0 0 0 
0 0 0 0 0 0 0 0 0 0 0 0 0 0 0 0 0 0 0 0 0 0 0 0 0 0 0 0 0 0 0 0 0 0 0 0 0 0 0 0 0 0 0 0 0 0 0 0 0 0 
0 0 0 0 0 0 0 0 0 0 0 0 0 0 0 0 0 0 0 0 0 0 0 0 0 0 0 0 0 0 0 0 0 0 0 0 0 0 0 0 0 0 0 0 0 0 0 0 0 0 
0 0 0 0 0 0 0 0 0 0 0 0 0 0 0 0 0 0 0 0 0 0 0 0 0 0 0 0 0 0 0 0 0 0 0 0 0 0 0 0 0 0 0 0 0 0 0 0 0 0 
0 0 0 0 0 0 0 0 0 0 0 0 0 0 0 0 0 0 0 0 0 0 0 0 0 0 0 0 0 0 0 0 0 0 0 0 0 0 0 0 0 0 0 0 0 0 0 0 0 0 
0 0 0 0 0 0 0 0 0 0 0 0 0 0 0 0 0 0 0 0 0 0 0 0 0 0 0 0 0 0 0 0 0 0 0 0 0 0 0 0 0 0 0 0 0 0 0 0 0 0 
0 0 0 0 0 0 0 0 0 0 0 0 0 0 0 0 0 0 0 0 0 0 0 0 0 0 0 0 0 0 0 0 0 0 0 0 0 0 0 0 0 0 0 0 0 0 0 0 0 0 
0 0 0 0 0 0 0 0 0 0 0 0 0 0 0 0 0 0 0 0 0 0 0 0 0 0 0 0 0 0 0 0 0 0 0 0 0 0 0 0 0 0 0 0 0 0 0 0 0 0 
0 0 0 0 0 0 0 0 0 0 0 0 0 0 0 0 0 0 0 0 0 0 0 0 0 0 0 0 0 0 0 0 0 0 0 0 0 0 0 0 0 0 0 0 0 0 0 0 0 0 

0.0 4.0 6.0 0.0 0.0 0.0 0.0 0.0 5.0 0.0 0.0 0.0 0.0 0.0 0.0 
0.0 0.0 5.0 5.0 4.0 5.0 0.0 0.0 0.0 0.0 0.0 0.0 0.0 0.0 4.0 
0.0 0.0 0.0 0.0 0.0 0.0 0.0 0.0 0.0 0.0 0.0 0.0 0.0 5.0 5.0 
0.0 0.0 0.0 0.0 0.0 0.0 0.0 0.0 0.0 0.0 0.0 0.0 0.0 0.0 0.0 
0.0 0.0 0.0 0.0 0.0 4.0 0.0 0.0 0.0 0.0 0.0 0.0 0.0 0.0 0.0 
0.0 0.0 0.0 0.0 0.0 5.0 0.0 0.0 0.0 0.0 5.0 0.0 0.0 0.0 4.0 
0.0 0.0 0.0 0.0 0.0 0.0 0.0 0.0 0.0 0.0 0.0 0.0 0.0 0.0 4.0 
0.0 0.0 0.0 0.0 0.0 0.0 0.0 6.0 0.0 0.0 0.0 0.0 0.0 0.0 0.0 
0.0 0.0 0.0 0.0 0.0 0.0 0.0 0.0 0.0 0.0 0.0 0.0 0.0 0.0 0.0 
0.0 0.0 0.0 0.0 0.0 0.0 0.0 0.0 0.0 0.0 0.0 0.0 4.0 0.0 0.0 
0.0 0.0 0.0 0.0 0.0 0.0 0.0 0.0 0.0 0.0 5.0 0.0 0.0 0.0 0.0 
0.0 0.0 0.0 0.0 0.0 0.0 0.0 0.0 0.0 0.0 0.0 0.0 0.0 0.0 0.0 
0.0 0.0 0.0 0.0 0.0 0.0 0.0 0.0 0.0 0.0 0.0 0.0 0.0 0.0 4.0 
0.0 0.0 0.0 0.0 0.0 0.0 0.0 0.0 0.0 0.0 0.0 0.0 0.0 4.0 4.0 
0.0 0.0 0.0 0.0 0.0 0.0 0.0 0.0 0.0 0.0 0.0 0.0 0.0 0.0 4.0 
0.0 0.0 0.0 0.0 0.0 0.0 0.0 0.0 0.0 0.0 0.0 0.0 0.0 0.0 0.0 
